to deard = to fear something happening in the future
a panic attack = a sudden feeling of intense fear which may include fast heart rate, sweating, shaking and being out of breath
together = confident and organised
anxiety = an uncomfortable feeling of nervousness or worry
a symptom = a sign you have an illness or health condition
to hyperventilate = to breathe too fast, causing too much oxygen to enter the blood
to spin =  to turn very fast
a distraction = something that stops you from focusing on what you're doing
Really looking forward to seeing you! - naprawd� czekam na ciebie
It's going to be so good to catch up finally - To b�dzie tak dobre, aby nasta� na koniec
An end of term report - sprawdzenie ko�cowe
TO DO A LARGE AMOUNT OF SHOPPING = TO SHOP TILL YOU DROP
CONVEYOR BELT = A MOVING BELT THAT TRANSPORTS OBJECTS
TO BE A PERFECT SIZE AND SHAPE FOR SOMEONE = TO FIL LIKE A GLOVE
TO BE THE MOST ADVENTAGOUS COMBINATION OF COST AND TO MEET CUSTOMER 
REQUIREMENTS = TO BE VALUE FOR MONEY
A PERSON ADDICTED TO SHOPPING = SHOPAHOLIC
TO APPLY A SIGNIFICANT AMOUNT OF PRESSURE ON A PROSPECTIVE BUYER = TO GIVE SOMEONE THE HARD SELL
A PERSON WHO STEALS GOODS FROM A SHOP WHIE PRETENDING TO BE A CUSTOMER = SHOPLIFTER
Criminal = a person who breaks the law
Steal = to take something without the permission or knowledge of the owner and keep it
Shake hands = greet each someone or say goodbye by briefly joining hands moving them slightly up and down
Diet = an eating plan in which someone eats less food, or only particular types of food, because they want to become thinner or for medical reasons
Series = a set of television or radio broadcasts on the same subject or using the same characters but in different situations
Very files have an extension after dot, for example name.py, name.js
Python is highly performant(wysoko wydajny) programing language 
an action to achieve a result = a strategy 
to behaver as if something is true = to pretend - udawanie
a situation where the results in very important = high stakes - wysoka stawka
the water that comes from your skin when you are very hot = sweat - poci� si�
to give the main points = to summarise - podsumowa�
forms and documents = paperwork - papiery, dokumenty
to make something into smaller parts = to break something down
packaging  = The material used to protect goods and present them to the customer 
I can't think = My brain shuts down
I won't be upset = I can take it 
I wanted to escape = I wanted to get out of it
I was really nervous or afraid = I come out I a cold sweat
I still don't understand = I'm still lost
I understand what you're saying = I get you
Delusion -  it is something different it than it is real
Slamming door - strong and fast close a door
product design = The process of producing or improving a product to suit customers' needs 
to lunch a product = To introduce a product to the customers for the first tame 
to have a good eye for detail = To be good at noticing the smaller but important parts of things 
to talk through something = To discuss something carefully and in detail
to clear something with somebody = To get approval or permission from somebody to do something
social media = Websites and apps like Facebook, Twitter, and Instagram
ironically = In a funny or strange way because it's unexpected 
unlike = Different from 
to miss out on = To not get the benefits of
addiction = Needing something too much or in unhealthy way 
early adopters = People who are the first to buy or use new technology
constantly = All the time without a break
to be cut off from = To have no access to
coin = To come up with
m�wi� za kogo� = To speak for itself
pre_approved = Already officially recognized and accepted
a remote area = Far away from towns of other populated places
a predicament = A difficult of challenging situation
obvious = Easy to understand or notice
the founder = Someone who starts a business
To expand the range of services = rozszerzy� zakres us�ug
Sounds like = is
Moved in = come to live here
Catch up = tell each other news about our lives
Keep going = don't stop moving
Let me know = tell me
Looking forward to = I'm exited about
To secure funding = do zabezpieczenia finansowania
Dump = it is throw  things(ball) in front of you  
It is got such = to ma takie..., to jest tak...
to dread going outside = przerazenie wychodzenia na zewnatrz
i find myself worrying about = martwie sie o  to
to say it out loud =  mowic to glosno
be surprised how common they are = dziwic sie jak czesto sa
loads of people have them =  wiele osob ma je
to sound weird =  brzemiec dziwnie
so hear me out = sluchaj mnie
may sound strange =  może brzmi dziwnie 
get used to = przywczaic sie do
being scared =  bac sie, bycie przerazonym

