struggle = walka, problem, trudnosc, walczyc, zmagac, szarpac
breathe = oddychac
just = po prostu, tylko, wlasnie, zaledwie, tuz
get over = przebolec, podejsc, przejechac, pokonac
though = chociaz, jednak 
anxiety = niepokoj, lek, obawa
literally = doslownie
dizzy =  zawroty glowy
hyperventilate = hiperwnetylowac
deliberately = celowo, swiadomie, umyslnie, specjalnie
instead of =  zamiast
invoke = wywolywany, przywolany
flip = obrot, odrocic, przewrocic
extend = rozszerzyc, przedlurzyc
disaster = katstrofa, nieszczescie, porazka
miserable = nieszczesliwy, nedzny, zalosny
stripe = pasek, belka
strip = tasma
rear = tylny
carriage = przewoz, powoz
interrupt = przeszkadzac
approach = podchodzic, metoda, zblizyc
agile approach = zmiene podejscie
reply = amswer
likely = probably
perhaps = prossibly
external = outside
track of time = poczucie czas
track = monitorowac
influence = wyplywac, oddzialowywac, oddzialywac
respectively = odpowiedno, kolejno
recall = pamientac, przypomniec sobie
essentially =  zasadniczo, glownie
tedious = nudny
bribing = przekupstwo
bribe = lapowka
cutlery = sztucce
quilt = koldra
digest food =  trawienie pokarmu
disease = illness
cube = kostka
eyelashes = rzesy
creature = stworzenia
insect = owad, robak
chase = poscig, gonic
barefoot = na bosaka
loopup = odnosnik
scenario = scenariusz
fairky = dosc, calkiem
ordinarly = zazwyczaj
supply = dostawa
variety = roznorodnosc, urozmaicenie
counter = licznik, zwalczac, przeciwdzialac
intersection = przeciecie
versatile = flexiable(wszechstronne, uniwersalne)
waste = odpad, marnowac, trwnoic
littering = makes our planet dirty
defend = bronic, obronic, chronic
reliance = zaleznosc
agenda = plan, program
postpone = przelozyc, odlozyc
looking forward = doczekac